111111101
101010001
101000001
101110101
100010101
101010111
100010111
100000011
111111111

